XXXXXXXXXXXXXXXXXXXXXX
X3212X212111123211112X
X2222X211131222112111X
X12XcX321113111111111X
X11XXX13131X113111211X
X121113211XaX21211233X
X1X1121131XX311212112X
X232111X1113111111211X
X22212XbX223111111111X
X22211XX12131122XXXXXX
X1111211211223132322dX
XXXXXXXXXXXXXXXXXXXXXX
